der Bauarbeiter - anleggsarbeideren
das Hängeschloss - hengelås
das Schloss - slott
der Ziegel - mursteinen
das Riesenrad - pariserhjulet
das Gebirge - fjellkjeden
zu sichern - å sikre
steil - bratt
zu erwähnen - å nevne
geheim - hemmelig
zugucken - se på
das Ergebnis - resultatet
die Ausbildung - utdannelsen
bleiben - forbli
darum - derfor
einfach - enkelt
die Wirtschaft - økonomien
ziehen - flytte
der einzige - den eneste
beliefern - levere til
der Auftrag - oppdraget
die Strecke - strekningen
oben - oppe
unten - nede
das Ungeheuer - uhyret
sanft - myk
riechen - lukte
bedenklich - mistenkelig
ausschlafen - sove ut
der Chor - koret
ungestört - uforstyrret
dafür - for dette
tauchen - dykke
zelten - sove i telt
wiederholen - gjenta
die Zeitung - avisen
reingehen - gå inn
der Besitzer - eieren
einladen - invitere
umdrehen - snu
die Gesellschaft - selskapet
der/die Verwandte - slektningen
zeitraubend - tidkrevende