anleggsarbeideren - der Bauarbeiter
hengelås - das Hängeschloss
slott - das Schloss
mursteinen - der Ziegel
pariserhjulet - das Riesenrad
fjellkjeden - das Gebirge
å sikre - zu sichern
bratt - steil
å nevne - zu erwähnen
hemmelig - geheim
se på - zugucken
resultatet - das Ergebnis
utdannelsen - die Ausbildung
forbli - bleiben
derfor - darum
enkelt - einfach
økonomien - die Wirtschaft
flytte - ziehen
den eneste - der einzige
levere til - beliefern
oppdraget - der Auftrag
strekningen - die Strecke
oppe - oben
nede - unten
uhyret - das Ungeheuer
myk - sanft
lukte - riechen
mistenkelig - bedenklich
sove ut - ausschlafen
koret - der Chor
uforstyrret - ungestört
for dette - dafür
dykke - tauchen
sove i telt - zelten
gjenta - wiederholen
avisen - die Zeitung
gå inn - reingehen
eieren - der Besitzer
invitere - einladen
snu - umdrehen
selskapet - die Gesellschaft
slektningen - der/die Verwandte
tidkrevende - zeitraubend
